0,1,2,3,4,5,6,7,8,9,10,11,12,13,14,15,16,17,17,17,18,19,20,21
22,23,24,25,26,27,17,28,29,30,31,32,33,34,35,36,37,38,39,40,41,42,43,44
45,46,47,48,49,50,17,51,52,53,54,55,56,57,58,59,60,61,62,63,64,65,66,67
68,69,70,71,72,73,74,75,76,77,78,79,17,80,81,82,83,84,85,86,87,88,89,90
91,92,93,94,95,96,97,98,99,100,101,102,103,104,105,106,107,108,109,110,17,111,112,17
113,114,115,116,117,118,119,120,121,122,123,124,125,126,127,128,129,130,131,17,17,132,133,17
134,135,136,137,138,139,140,141,142,143,144,145,146,147,148,149,150,151,152,17,17,153,154,17
17,155,156,157,158,159,160,161,162,163,164,165,17,166,167,168,169,170,171,172,173,174,175,176
177,178,17,17,17,17,179,180,17,181,182,183,184,185,186,187,188,189,190,17,17,17,17,17
17,191,17,17,17,17,192,193,17,194,195,196,197,198,199,200,201,202,203,17,17,17,17,17
17,17,17,17,17,17,17,17,204,205,206,207,208,209,210,211,17,17,17,17,17,17,17,17
17,17,17,17,17,17,17,17,212,213,214,215,17,216,217,218,17,17,17,17,17,17,17,17
17,219,220,221,222,223,224,225,226,227,228,229,230,231,232,233,17,17,17,17,17,17,17,17
17,234,235,236,237,238,239,240,241,242,243,244,245,246,247,248,17,17,17,17,17,17,17,17
249,250,251,252,253,254,148,255,256,257,258,259,260,261,58,262,17,17,17,17,17,17,17,17
263,264,265,266,17,267,268,269,270,271,272,273,17,274,275,276,17,17,17,17,17,17,17,17
